Signin Page:
    |
    \
    ---> APP


# APP
~~~~~~~~~~~~~~~~~~~~~~~~~~~~~~~~~~~~~~~~~~~~~~~~
~           ~                                  ~
~           ~                                  ~
~           ~                                  ~
~           ~                                  ~
~           ~                                  ~
~           ~                                  ~
~           ~                                  ~
~           ~                                  ~
~           ~                                  ~
~           ~                                  ~
~           ~                                  ~
~           ~                                  ~
~           ~                                  ~
~           ~                                  ~
~           ~                                  ~
~           ~~~~~~~~~~~~~~~~~~~~~~~~~~~~~~~~~~~~
~           ~                                  ~
~           ~                                  ~
~           ~                                  ~
~~~~~~~~~~~~~~~~~~~~~~~~~~~~~~~~~~~~~~~~~~~~~~~~